变量名,boss,boss2,boss501,boss502,boss503,boss504,boss505,boss506,boss601,mineboss1,mineboss2,mineboss3
默认值,2,2,1,1,1,1,1,1,1,1,1,1
角色等级,boss场景修正,boss场景修正,boss场景修正,boss场景修正,boss场景修正,boss场景修正,boss场景修正,boss场景修正,boss场景修正,boss场景修正,boss场景修正,boss场景修正
1,4,5,4,4,4,5,6,7,6,4,5,6
2,8,10,8,8,8,10,12,14,12,8,10,12
3,12,15,12,12,12,15,17,20,17,12,14,17
4,16,20,16,16,16,20,23,26,23,16,19,23
5,20,25,20,20,20,25,29,33,29,20,24,29
6,24,30,24,24,24,30,35,40,35,24,29,35
7,28,35,28,28,28,35,40,46,40,28,34,41
8,32,40,32,32,32,40,46,53,46,32,38,46
9,36,45,36,36,36,45,52,60,52,36,43,52
10,40,50,40,40,40,50,58,67,58,40,48,58
11,44,55,44,44,44,55,63,72,63,44,53,64
12,48,60,48,48,48,60,69,79,69,48,58,70
13,52,65,52,52,52,65,75,86,75,52,62,74
14,56,70,56,56,56,70,81,93,81,56,67,80
15,60,75,60,60,60,75,86,99,86,60,72,86
16,64,80,64,64,64,80,92,106,92,64,77,92
17,68,85,68,68,68,85,98,113,98,68,82,98
18,72,90,72,72,72,90,104,120,104,72,86,103
19,76,95,76,76,76,95,109,125,109,76,91,109
20,80,100,80,80,80,100,115,132,115,80,96,115
21,84,105,84,84,84,105,121,139,121,84,101,121
22,88,110,88,88,88,110,127,146,127,88,106,127
23,92,115,92,92,92,115,132,152,132,92,110,132
24,96,120,96,96,96,120,138,159,138,96,115,138
25,100,125,100,100,100,125,144,166,144,100,120,144
26,104,130,104,104,104,130,150,173,150,104,125,150
27,108,135,108,108,108,135,155,178,155,108,130,156
28,112,140,112,112,112,140,161,185,161,112,134,161
29,116,145,116,116,116,145,167,192,167,116,139,167
30,120,150,120,120,120,150,173,199,173,120,144,173
31,124,155,124,124,124,155,178,205,178,124,149,179
32,128,160,128,128,128,160,184,212,184,128,154,185
33,132,165,132,132,132,165,190,219,190,132,158,190
34,136,170,136,136,136,170,196,225,196,136,163,196
35,140,175,140,140,140,175,201,231,201,140,168,202
36,144,180,144,144,144,180,207,238,207,144,173,208
37,148,185,148,148,148,185,213,245,213,148,178,214
38,152,190,152,152,152,190,219,252,219,152,182,218
39,156,195,156,156,156,195,224,258,224,156,187,224
40,160,200,160,160,160,200,230,265,230,160,192,230
41,164,205,164,164,164,205,236,271,236,164,197,236
42,168,210,168,168,168,210,242,278,242,168,202,242
43,172,215,172,172,172,215,247,284,247,172,206,247
44,176,220,176,176,176,220,253,291,253,176,211,253
45,180,225,180,180,180,225,259,298,259,180,216,259
46,184,230,184,184,184,230,265,305,265,184,221,265
47,188,235,188,188,188,235,270,311,270,188,226,271
48,192,240,192,192,192,240,276,317,276,192,230,276
49,196,245,196,196,196,245,282,324,282,196,235,282
50,200,250,200,200,200,250,288,331,288,200,240,288
51,204,255,204,204,204,255,293,337,293,204,245,294
52,208,260,208,208,208,260,299,344,299,208,250,300
53,212,265,212,212,212,265,305,351,305,212,254,305
54,216,270,216,216,216,270,311,358,311,216,259,311
55,220,275,220,220,220,275,316,363,316,220,264,317
56,224,280,224,224,224,280,322,370,322,224,269,323
57,228,285,228,228,228,285,328,377,328,228,274,329
58,232,290,232,232,232,290,334,384,334,232,278,334
59,236,295,236,236,236,295,339,390,339,236,283,340
60,240,300,240,240,240,300,345,397,345,240,288,346
61,244,305,244,244,244,305,351,404,351,244,293,352
62,248,310,248,248,248,310,357,411,357,248,298,358
63,252,315,252,252,252,315,362,416,362,252,302,362
64,256,320,256,256,256,320,368,423,368,256,307,368
65,260,325,260,260,260,325,374,430,374,260,312,374
66,264,330,264,264,264,330,380,437,380,264,317,380
67,268,335,268,268,268,335,385,443,385,268,322,386
68,272,340,272,272,272,340,391,450,391,272,326,391
69,276,345,276,276,276,345,397,457,397,276,331,397
70,280,350,280,280,280,350,403,463,403,280,336,403
71,284,355,284,284,284,355,408,469,408,284,341,409
72,288,360,288,288,288,360,414,476,414,288,346,415
73,292,365,292,292,292,365,420,483,420,292,350,420
74,296,370,296,296,296,370,426,490,426,296,355,426
75,300,375,300,300,300,375,431,496,431,300,360,432
76,304,380,304,304,304,380,437,503,437,304,365,438
77,308,385,308,308,308,385,443,509,443,308,370,444
78,312,390,312,312,312,390,449,516,449,312,374,449
79,316,395,316,316,316,395,454,522,454,316,379,455
80,320,400,320,320,320,400,460,529,460,320,384,461
81,324,405,324,324,324,405,466,536,466,324,389,467
82,328,410,328,328,328,410,472,543,472,328,394,473
83,332,415,332,332,332,415,477,549,477,332,398,478
84,336,420,336,336,336,420,483,555,483,336,403,484
85,340,425,340,340,340,425,489,562,489,340,408,490
86,344,430,344,344,344,430,495,569,495,344,413,496
87,348,435,348,348,348,435,500,575,500,348,418,502
88,352,440,352,352,352,440,506,582,506,352,422,506
89,356,445,356,356,356,445,512,589,512,356,427,512
90,360,450,360,360,360,450,518,596,518,360,432,518
91,364,455,364,364,364,455,523,601,523,364,437,524
92,368,460,368,368,368,460,529,608,529,368,442,530
93,372,465,372,372,372,465,535,615,535,372,446,535
94,376,470,376,376,376,470,541,622,541,376,451,541
95,380,475,380,380,380,475,546,628,546,380,456,547
96,384,480,384,384,384,480,552,635,552,384,461,553
97,388,485,388,388,388,485,558,642,558,388,466,559
98,392,490,392,392,392,490,564,649,564,392,470,564
99,396,495,396,396,396,495,569,654,569,396,475,570
100,400,500,400,400,400,500,575,661,575,400,480,576
101,404,505,404,404,404,505,581,668,581,404,485,582
102,408,510,408,408,408,510,587,675,587,408,490,588
103,412,515,412,412,412,515,593,682,593,412,495,594
104,416,520,416,416,416,520,599,689,599,416,500,600
105,420,525,420,420,420,525,605,696,605,420,505,606
106,424,530,424,424,424,530,611,703,611,424,510,612
107,428,535,428,428,428,535,617,710,617,428,515,618
108,432,540,432,432,432,540,623,717,623,432,520,624
109,436,545,436,436,436,545,629,724,629,436,525,630
110,440,550,440,440,440,550,635,731,635,440,530,636
111,444,555,444,444,444,555,641,738,641,444,535,642
112,448,560,448,448,448,560,647,745,647,448,540,648
113,452,565,452,452,452,565,653,752,653,452,545,654
114,456,570,456,456,456,570,659,759,659,456,550,660
115,460,575,460,460,460,575,665,766,665,460,555,666
116,464,580,464,464,464,580,671,773,671,464,560,672
117,468,585,468,468,468,585,677,780,677,468,565,678
118,472,590,472,472,472,590,683,787,683,472,570,684
119,476,595,476,476,476,595,689,794,689,476,575,690
120,480,600,480,480,480,600,695,801,695,480,580,696
121,484,605,484,484,484,605,701,808,701,484,585,702
122,488,610,488,488,488,610,707,815,707,488,590,708
123,492,615,492,492,492,615,713,822,713,492,595,714
124,496,620,496,496,496,620,719,829,719,496,600,720
125,500,625,500,500,500,625,725,836,725,500,605,726
126,504,630,504,504,504,630,731,843,731,504,610,732
127,508,635,508,508,508,635,737,850,737,508,615,738
128,512,640,512,512,512,640,743,857,743,512,620,744
129,516,645,516,516,516,645,749,864,749,516,625,750
130,520,650,520,520,520,650,755,871,755,520,630,756
131,524,655,524,524,524,655,761,878,761,524,635,762
132,528,660,528,528,528,660,767,885,767,528,640,768
133,532,665,532,532,532,665,773,892,773,532,645,774
134,536,670,536,536,536,670,779,899,779,536,650,780
135,540,675,540,540,540,675,785,906,785,540,655,786
136,544,680,544,544,544,680,791,913,791,544,660,792
137,548,685,548,548,548,685,797,920,797,548,665,798
138,552,690,552,552,552,690,803,927,803,552,670,804
139,556,695,556,556,556,695,809,934,809,556,675,810
140,560,700,560,560,560,700,815,941,815,560,680,816
141,564,705,564,564,564,705,821,948,821,564,685,822
142,568,710,568,568,568,710,827,955,827,568,690,828
143,572,715,572,572,572,715,833,962,833,572,695,834
144,576,720,576,576,576,720,839,969,839,576,700,840
145,580,725,580,580,580,725,845,976,845,580,705,846
146,584,730,584,584,584,730,851,983,851,584,710,852
147,588,735,588,588,588,735,857,990,857,588,715,858
148,592,740,592,592,592,740,863,997,863,592,720,864
149,596,745,596,596,596,745,869,1004,869,596,725,870
150,600,750,600,600,600,750,875,1011,875,600,730,876
151,604,755,604,604,604,755,881,1018,881,604,735,882
152,608,760,608,608,608,760,887,1025,887,608,740,888
153,612,765,612,612,612,765,893,1032,893,612,745,894
154,616,770,616,616,616,770,899,1039,899,616,750,900
155,620,775,620,620,620,775,905,1046,905,620,755,906
156,624,780,624,624,624,780,911,1053,911,624,760,912
157,628,785,628,628,628,785,917,1060,917,628,765,918
158,632,790,632,632,632,790,923,1067,923,632,770,924
159,636,795,636,636,636,795,929,1074,929,636,775,930
160,640,800,640,640,640,800,935,1081,935,640,780,936
161,644,805,644,644,644,805,941,1088,941,646,785,942
162,648,810,648,648,648,810,947,1095,947,652,790,948
163,652,815,652,652,652,815,953,1102,953,658,795,954
164,656,820,656,656,656,820,959,1109,959,664,800,960
165,660,825,660,660,660,825,965,1116,965,670,805,966
166,664,830,664,664,664,830,971,1123,971,676,810,972
167,668,835,668,668,668,835,977,1130,977,682,815,978
168,672,840,672,672,672,840,983,1137,983,688,820,984
169,676,845,676,676,676,845,989,1144,989,694,825,990
170,680,850,680,680,680,850,995,1151,995,700,830,996
171,684,855,684,684,684,855,1001,1158,1001,706,835,1002
172,688,860,688,688,688,860,1007,1165,1007,712,840,1008
173,692,865,692,692,692,865,1013,1172,1013,718,845,1014
174,696,870,696,696,696,870,1019,1179,1019,724,850,1020
175,700,875,700,700,700,875,1025,1186,1025,730,855,1026
176,704,880,704,704,704,880,1031,1193,1031,736,860,1032
177,708,885,708,708,708,885,1037,1200,1037,742,865,1038
178,712,890,712,712,712,890,1043,1207,1043,748,870,1044
179,716,895,716,716,716,895,1049,1214,1049,754,875,1050
180,720,900,720,720,720,900,1055,1221,1055,760,880,1056
181,724,905,724,724,724,905,1061,1228,1061,766,885,1062
182,728,910,728,728,728,910,1067,1235,1067,772,890,1068
183,732,915,732,732,732,915,1073,1242,1073,778,895,1074
184,736,920,736,736,736,920,1079,1249,1079,784,900,1080
185,740,925,740,740,740,925,1085,1256,1085,790,905,1086
186,744,930,744,744,744,930,1091,1263,1091,796,910,1092
187,748,935,748,748,748,935,1097,1270,1097,802,915,1098
188,752,940,752,752,752,940,1103,1277,1103,808,920,1104
189,756,945,756,756,756,945,1109,1284,1109,814,925,1110
190,760,950,760,760,760,950,1115,1291,1115,820,930,1116
191,764,955,764,764,764,955,1121,1298,1121,826,935,1122
192,768,960,768,768,768,960,1127,1305,1127,832,940,1128
193,772,965,772,772,772,965,1133,1312,1133,838,945,1134
194,776,970,776,776,776,970,1139,1319,1139,844,950,1140
195,780,975,780,780,780,975,1145,1326,1145,850,955,1146
196,784,980,784,784,784,980,1151,1333,1151,856,960,1152
197,788,985,788,788,788,985,1157,1340,1157,862,965,1158
198,792,990,792,792,792,990,1163,1347,1163,868,970,1164
199,796,995,796,796,796,995,1169,1354,1169,874,975,1170
200,800,1000,800,800,800,1000,1175,1361,1175,880,980,1176
